####################
#@...$.....*.......#
#..#####...........#
#....*.....##......#
#......$....#..!...#
#..........##......#
#..........##......#
#..........##......#
#..........##......#
#..........##......#
#..........##......#
#..........##......#
#..........##......#
#..................#
####################