####################/-----\
#@...$.....*.......==.....|
#..#####...........#|.....|
#....*.....##......#|.....|
#......$....#..!...#|.....|
#..........##......#|.....|
#..........##......#|.....|
#..........##......#|.....|
#..........##......#|.....|
#..........##......#|.....|
#..........##......#|.__|.|
#..........##......# /....|
#..........##......#/.....|
#..................#|...!.|
####################\_____/